はくしん	（迫真）	名詞	
こえだけはくしん	（声だけ迫真）	名詞	
めいえんぎ	（名演技）	名詞	
そんけい	（尊敬）	名詞	
ねはん	（涅槃）	名詞	
すなお	（素直）	名詞	
す	（素）	名詞	
あんにゅい	（アンニュイ）	名詞	
ぼうよみ	（棒読み）	名詞	
ふるえごえ	（震え声）	名詞	
しゃがれごえ	（しゃがれ声）	名詞	
こごえ	（小声）	名詞	
むち	（無知）	名詞	
むてき	（無敵）	名詞	
じゅうじゅん	（従順）	名詞	
ちからこぶ	（力こぶ）	名詞	
きょうみ	（興味）	名詞	
きょうみしんしん	（興味深々）	名詞	
こうふん	（興奮）	名詞	
こうきしん	（好奇心）	名詞	
きたい	（期待）	名詞	
かみのぼうよみ	（神の棒読み）	名詞	
がちびんた	（ガチビンタ）	名詞	
しふく	（至福）	名詞	
かんき	（歓喜）	名詞	
かんどう	（感動）	名詞	
へんけん	（偏見）	名詞	
ちゅうに	（厨二）	名詞	
ちょくゆ	（直喩）	名詞	
こうこつ	（恍惚）	名詞	
くうき	（空気）	名詞	
やくちゅう	（ヤク中）	名詞	
ふんど	（憤怒）	名詞	
げきど	（激怒）	名詞	
はんぎれ	（半ギレ）	名詞	
ふんがい	（憤慨）	名詞	
いあつ	（威圧）	名詞	
ぎふん	（義憤）	名詞	
ぶじょく	（侮辱）	名詞	
ぶべつ	（侮蔑）	名詞	
ちょうはつ	（挑発）	名詞	
ぎもん	（疑問）	名詞	
さいぎ	（猜疑）	名詞	
とうとつ	（唐突）	名詞	
かみかみ	（噛み噛み）	名詞	
ごまんえつ	（ご満悦顔）	名詞	
はんわらい	（半笑い）	名詞	
はらぱん	（腹パン）	名詞	
びんじょう	（便乗）	名詞	
きょうたん	（驚嘆）	名詞	
かんしん	（感心）	名詞	
すっとぼけ	（すっとぼけ）	名詞	
ていあん	（提案）	名詞	
げんちょう	（幻聴）	名詞	
なんちょう	（難聴）	名詞	
ばとう	（罵倒）	名詞	
ほもがき	（ホモガキ）	名詞	
きょうがく	（驚愕）	名詞	
どんびき	（ドン引き）	名詞	
きょうふ	（恐怖）	名詞	
いふ	（畏怖）	名詞	
ぜつぼう	（絶望）	名詞	
せんりつ	（戦慄）	名詞	
はっきょう	（発狂）	名詞	
なみだめ	（涙目）	名詞	
ちょうりろん	（超理論）	名詞	
あきれ	（呆れ）	名詞	
れいせい	（冷静）	名詞	
むかんしん	（無関心）	名詞	
ぜっく	（絶句）	名詞	
ためいき	（溜息）	名詞	
ちょうしょう	（嘲笑）	名詞	
おうと	（嘔吐）	名詞	
いけぬま	（池沼）	名詞	
せいろん	（正論）	名詞	
ろんぱ	（論破）	名詞	
どやがお	（ドヤ顔）	名詞	
げすがお	（ゲス顔）	名詞	
まじきちがお	（マジキチ顔）	名詞	
びしょう	（微笑）	名詞	
むひょうじょう	（無表情）	名詞	
すりーでぃーだくおん	（3D濁音）	名詞	
こうさつ	（考察）	名詞	
おおうそ	（大嘘）	名詞	
ほんしん	（本心）	名詞	
ほんき	（本気）	名詞	
うろおぼえ	（うろ覚え）	名詞	
かくしん	（確信）	名詞	
そくとう	（即答）	名詞	
ことりのさえずり	（小鳥の囀り）	名詞	
ほんね	（本音）	名詞	
げんめい	（厳命）	名詞	
いましめ	（戒め）	名詞	
めいれい	（命令）	名詞	
あどばいす	（アドバイス）	名詞	
りょうしん	（良心）	名詞	
めいげん	（名言）	名詞	
しげん	（至言）	名詞	
かくげん	（格言）	名詞	
ねっとり	（ねっとり）	名詞	
きちく	（鬼畜）	名詞	
くいぎみ	（食い気味）	名詞	
びんじょう	（便乗）	名詞	
ゆうじゅうふだん	（優柔不断）	名詞	
すっとぼけ	（すっとぼけ）	名詞	
えすえぬでぃーえるきょうじゅ	（SNDL教授）	名詞	
なかじまほも	（中島ほも）	名詞	
どちんぴら	（ドチンピラ）	名詞	
じんぎ	（仁義）	名詞	
きぜん	（毅然）	名詞	
いみしん	（意味深）	名詞	
とうとつ	（唐突）	名詞	
あいがん	（哀願）	名詞	
いみふめい	（意味不明）	名詞	
たりきほんがん	（他力本願）	名詞	
むちゃぶり	（無茶振り）	名詞	
もろかぶり	（モロ被り）	名詞	
まじれす	（マジレス）	名詞	
するとはいってない	（○○するとは言っていない）	名詞	
なみのかんそう	（○○並みの感想）	名詞	
まんざらでもない	（満更でもない）	名詞	
こんしんのぎゃく	（渾身のギャグ）	名詞	
あんこくびしょう	（暗黒微笑）	名詞	
まじきちすまいる	（マジキチスマイル）	名詞	
りすぺくと	（○○リスペクト）	名詞	
さらなるたかみへ	（さらなる高みへ）	名詞	
かくご	（覚悟）	名詞	
まじぎれ	（マジギレ）	名詞	
むひょうじょう	（無表情）	名詞	
せっかち	（せっかち）	名詞	
ちほう	（痴呆）	名詞	
